..............................
..............................
..............................
..............................
..............................
...$.......1..........$.......
...........X..X...............
...@.....$XX..XX......1.......
X.......XXXX.2XXXX...XXX......
XXXXXXXXXXXXXXXXXXXXXXXXXXXXXX
