XX................XX
X...@..........X...X
....X.........XXX...
....X..XXXXXX..X....
X...X...XXXXX.......
X...XXXXX...X......X
XX..X.......X.....XX
