XX................XX
X...@..........X1..X
....X.........XXX...
....X..XXXXXX..X....
X...X...XXXXX.......
X...XXXXX...X......X
XX..X.......X.....XX
