XX................XX
X..............X...X
........1.....XXX...
......XXXXXXX..X....
@.......XXXXX.......
X...XXXXX...X......X
XX..X.......X.....XX
