XX................XX
X..................X
........1...........
......XXXXXXX.......
@.......XXXXX.......
X...XXXXX...X......X
XX..X.......X.....XX
